25 50
219 4 0 31 15 15 219 15 0 31 12 15 219 15 0 30 6 15 219 15 0 31 10 15 219 15 0 30 3 15 219 15 0 31 1 15 30 15 15 30 13 15 219 15 0 31 4 15 219 15 0 30 12 15 219 15 0 31 6 15 219 15 0 30 3 15 219 15 0 31 1 15 219 15 0 30 13 15 219 15 0 31 4 15 219 15 0 30 12 15 219 15 0 31 6 15 219 15 0 30 2 15 219 15 0 31 3 15 219 15 0 30 1 15 31 15 15 31 4 15 219 15 0 30 12 15 219 15 0 31 6 15 219 15 0 30 2 15 219 15 0 31 15 15 31 15 15 219 15 0 
219 0 0 32 15 0 32 15 0 32 15 0 32 15 0 219 13 0 32 15 0 32 15 0 32 15 0 32 15 0 32 15 0 32 15 0 32 15 0 32 15 0 32 15 0 32 15 0 32 15 0 219 13 0 32 15 0 32 15 0 32 15 0 32 15 0 32 15 0 32 0 0 32 15 0 32 15 0 32 15 0 32 15 0 32 15 0 32 15 0 32 15 0 32 15 0 32 15 0 32 15 0 32 15 0 32 15 0 32 15 0 32 15 0 32 15 0 32 15 0 32 15 0 32 15 0 32 15 0 32 15 0 32 15 0 32 15 0 32 15 0 32 15 0 32 15 0 219 15 0 
219 4 0 219 3 0 219 3 0 219 3 0 219 3 0 219 3 0 219 3 0 219 3 0 219 3 0 219 3 0 219 3 0 219 3 0 219 3 0 219 3 0 219 3 0 219 3 0 219 3 0 219 3 0 219 3 0 219 3 0 219 3 0 219 3 0 219 3 0 219 3 0 219 3 0 219 3 0 219 3 0 219 3 0 32 0 0 219 3 0 219 3 0 219 3 0 219 3 0 219 3 0 219 3 0 219 3 0 219 3 0 219 3 0 219 3 0 219 3 0 219 3 0 219 3 0 219 3 0 219 3 0 219 3 0 219 3 0 219 3 0 219 3 0 219 3 0 219 15 0 
219 15 0 32 15 0 83 7 0 84 7 0 65 7 0 82 7 0 84 7 0 32 15 0 32 15 0 32 15 0 32 15 0 32 15 0 32 15 0 32 15 0 32 15 0 32 15 0 32 15 0 32 15 0 32 15 0 32 15 0 32 15 0 32 15 0 32 15 0 32 15 0 32 15 0 32 15 0 219 0 0 219 3 0 32 15 0 219 3 0 32 15 0 32 15 0 32 15 0 32 15 0 32 15 0 32 15 0 32 15 0 32 15 0 32 15 0 32 15 0 32 15 0 32 15 0 32 15 0 32 15 0 32 15 0 32 15 0 32 15 0 32 15 0 32 15 0 219 15 0 
219 15 0 32 15 0 32 15 0 32 15 0 32 15 0 32 15 0 32 15 0 32 15 0 32 15 0 32 15 0 32 15 0 32 15 0 32 15 0 32 15 0 32 15 0 32 15 0 32 15 0 32 15 0 32 15 0 32 15 0 32 15 0 32 15 0 32 15 0 32 15 0 32 15 0 32 15 0 219 0 0 219 3 0 32 0 0 219 3 0 32 15 0 32 15 0 32 15 0 32 15 0 32 15 0 220 3 0 220 3 0 220 3 0 220 3 0 220 3 0 220 3 0 220 3 0 220 3 0 220 3 0 220 3 0 219 0 0 32 15 0 32 15 0 32 15 0 219 15 0 
219 15 0 32 15 0 32 15 0 32 15 0 32 15 0 32 15 0 32 15 0 220 0 0 220 0 0 220 0 0 220 0 0 219 0 0 220 3 0 220 3 0 220 3 0 220 3 0 220 3 0 220 3 0 220 3 0 220 3 0 220 3 0 220 3 0 220 3 0 220 3 0 220 3 0 220 3 0 220 3 0 219 3 0 32 0 0 219 3 0 32 15 0 32 15 0 32 15 0 32 15 0 32 15 0 219 3 0 32 0 0 32 0 0 32 0 0 32 0 0 32 0 0 32 0 0 32 0 0 32 0 0 219 3 0 219 0 0 32 15 0 32 15 0 32 15 0 219 15 0 
219 15 0 32 15 0 32 15 0 32 3 0 32 3 0 32 3 0 32 15 0 32 15 0 220 0 0 220 0 0 32 15 0 219 0 0 219 3 0 32 0 0 32 0 0 32 0 0 32 0 0 32 0 0 219 13 0 32 0 0 32 0 0 32 0 0 32 0 0 32 0 0 32 0 0 32 0 0 32 0 0 32 0 0 32 0 0 219 3 0 32 15 0 32 15 0 32 15 0 32 15 0 32 15 0 219 3 0 32 15 0 219 3 0 223 3 0 223 3 0 223 3 0 223 3 0 219 3 0 32 0 0 219 3 0 219 0 0 32 15 0 32 15 0 32 15 0 219 15 0 
219 15 0 32 15 0 32 15 0 32 3 0 32 0 0 32 3 0 32 15 0 32 15 0 32 15 0 32 15 0 32 15 0 219 0 0 219 3 0 32 0 0 219 3 0 223 3 0 223 3 0 223 3 0 223 3 0 223 3 0 223 3 0 223 3 0 223 3 0 223 3 0 223 3 0 223 3 0 223 3 0 223 3 0 223 3 0 223 3 0 32 15 0 32 15 0 32 15 0 32 15 0 32 15 0 219 3 0 32 0 0 219 3 0 32 15 0 32 15 0 32 15 0 220 0 0 219 3 0 32 0 0 219 3 0 32 15 0 32 15 0 32 15 0 32 15 0 219 15 0 
219 15 0 32 15 0 32 15 0 32 3 0 32 0 0 32 3 0 32 3 0 32 3 0 32 3 0 32 3 0 32 3 0 32 3 0 219 3 0 32 0 0 219 3 0 32 15 0 32 15 0 32 15 0 32 15 0 32 15 0 32 15 0 32 15 0 32 15 0 32 15 0 32 15 0 32 15 0 32 15 0 32 15 0 32 15 0 32 15 0 32 15 0 32 15 0 32 15 0 32 15 0 32 15 0 219 3 0 32 0 0 219 3 0 32 15 0 32 15 0 32 15 0 32 15 0 219 3 0 32 3 0 219 3 0 32 15 0 32 15 0 32 15 0 32 15 0 219 15 0 
219 15 0 32 15 0 32 15 0 32 3 0 32 0 0 32 0 0 32 0 0 32 0 0 32 0 0 32 0 0 32 0 0 32 3 0 219 3 0 32 0 0 219 3 0 32 15 0 32 15 0 32 15 0 32 15 0 32 15 0 32 15 0 32 15 0 32 15 0 32 15 0 32 15 0 32 15 0 32 15 0 32 15 0 32 15 0 32 15 0 32 15 0 32 15 0 32 15 0 32 15 0 32 15 0 219 3 0 32 0 0 219 3 0 32 15 0 32 15 0 32 15 0 32 15 0 219 3 0 32 0 0 219 3 0 32 15 0 32 15 0 32 15 0 32 15 0 219 15 0 
219 15 0 32 15 0 32 15 0 32 3 0 32 3 0 32 3 0 32 3 0 32 3 0 32 3 0 32 3 0 32 3 0 32 3 0 219 3 0 32 0 0 219 3 0 32 15 0 32 15 0 32 15 0 32 15 0 32 15 0 32 15 0 32 15 0 32 15 0 32 15 0 32 15 0 32 15 0 32 15 0 32 15 0 32 15 0 32 15 0 32 15 0 32 15 0 32 15 0 32 15 0 32 15 0 219 3 0 32 0 0 219 3 0 32 15 0 32 15 0 32 15 0 32 15 0 219 3 0 32 3 0 219 3 0 32 15 0 32 15 0 32 15 0 32 15 0 219 15 0 
219 15 0 32 15 0 32 15 0 32 15 0 32 15 0 32 15 0 32 15 0 32 15 0 32 15 0 32 15 0 219 0 0 219 0 0 219 3 0 32 0 0 219 3 0 220 3 0 220 3 0 220 3 0 220 3 0 220 3 0 220 3 0 220 3 0 220 3 0 220 3 0 220 3 0 220 3 0 220 3 0 220 3 0 220 3 0 220 3 0 220 3 0 220 3 0 220 3 0 220 3 0 220 3 0 219 3 0 32 0 0 219 3 0 32 15 0 32 15 0 32 15 0 32 15 0 219 3 0 32 0 0 219 3 0 32 15 0 32 15 0 32 15 0 32 15 0 219 15 0 
219 15 0 32 15 0 32 15 0 32 15 0 32 15 0 32 15 0 32 15 0 32 15 0 32 15 0 32 15 0 219 0 0 219 0 0 219 3 0 32 0 0 32 0 0 32 0 0 32 0 0 32 0 0 32 0 0 32 0 0 32 0 0 32 0 0 32 0 0 32 0 0 32 0 0 32 0 0 32 0 0 32 0 0 32 0 0 32 0 0 32 0 0 32 0 0 32 0 0 32 15 0 32 0 0 32 0 0 32 15 0 219 3 0 32 15 0 32 15 0 32 15 0 32 15 0 219 3 0 32 15 0 219 3 0 32 15 0 32 15 0 32 15 0 32 15 0 219 15 0 
219 15 0 32 15 0 32 15 0 32 15 0 32 15 0 32 15 0 32 15 0 32 15 0 32 15 0 32 15 0 32 15 0 32 15 0 223 3 0 223 3 0 223 3 0 223 3 0 223 3 0 223 3 0 219 3 0 32 0 0 219 3 0 223 3 0 223 3 0 223 3 0 223 3 0 223 3 0 223 3 0 223 3 0 223 3 0 223 3 0 223 3 0 223 3 0 223 3 0 223 3 0 223 3 0 223 3 0 223 3 0 223 3 0 223 0 0 32 15 0 32 15 0 219 0 0 219 3 0 32 0 0 219 3 0 219 0 0 32 15 0 32 15 0 32 15 0 219 15 0 
219 15 0 32 15 0 220 3 0 220 3 0 220 3 0 220 3 0 220 3 0 220 3 0 220 3 0 220 3 0 220 3 0 220 3 0 220 3 0 220 3 0 220 3 0 220 3 0 220 3 0 220 3 0 219 3 0 32 0 0 219 3 0 220 3 0 220 3 0 220 3 0 219 0 0 220 3 0 220 3 0 220 3 0 220 3 0 220 3 0 220 3 0 220 3 0 220 3 0 220 3 0 220 3 0 220 3 0 220 3 0 220 3 0 220 3 0 220 3 0 220 3 0 220 3 0 219 3 0 32 0 0 219 3 0 219 0 0 219 0 0 32 15 0 32 15 0 219 15 0 
219 15 0 32 15 0 219 3 0 32 0 0 32 0 0 32 0 0 32 0 0 32 0 0 32 0 0 32 0 0 32 0 0 32 0 0 32 0 0 32 0 0 32 0 0 32 0 0 32 0 0 32 0 0 32 0 0 32 0 0 32 0 0 32 0 0 32 0 0 219 3 0 219 0 0 219 3 0 32 0 0 32 0 0 32 0 0 32 0 0 32 0 0 32 0 0 219 3 0 32 0 0 32 0 0 32 0 0 32 0 0 32 0 0 32 0 0 32 0 0 32 0 0 32 0 0 32 0 0 32 0 0 219 3 0 32 15 0 32 15 0 32 15 0 32 15 0 219 15 0 
219 15 0 32 15 0 219 3 0 219 13 0 219 3 0 223 3 0 223 3 0 223 3 0 223 3 0 223 3 0 223 3 0 223 3 0 223 3 0 223 3 0 223 3 0 223 3 0 223 3 0 223 3 0 223 3 0 223 3 0 223 3 0 223 3 0 223 3 0 223 3 0 219 0 0 219 3 0 32 0 0 219 3 0 223 3 0 223 3 0 223 3 0 223 3 0 223 3 0 223 3 0 223 3 0 223 3 0 223 3 0 223 3 0 223 3 0 223 3 0 223 3 0 223 3 0 223 3 0 223 3 0 223 3 0 32 15 0 32 15 0 32 15 0 32 15 0 219 15 0 
219 15 0 32 15 0 219 3 0 32 0 0 219 3 0 219 0 0 32 15 0 32 15 0 32 3 0 32 3 0 32 3 0 32 3 0 32 3 0 32 3 0 32 3 0 32 3 0 32 3 0 32 3 0 32 15 0 32 15 0 32 15 0 32 15 0 32 15 0 32 15 0 32 15 0 219 3 0 32 0 0 219 3 0 32 15 0 32 15 0 32 15 0 32 15 0 32 15 0 32 15 0 32 15 0 32 15 0 32 15 0 32 15 0 32 15 0 32 15 0 32 15 0 32 15 0 32 15 0 32 15 0 32 15 0 32 15 0 32 15 0 32 15 0 32 15 0 219 15 0 
219 15 0 32 15 0 219 3 0 32 0 0 219 3 0 219 0 0 32 15 0 32 15 0 32 3 0 32 0 0 32 0 0 32 0 0 32 0 0 32 0 0 32 0 0 32 0 0 32 0 0 32 3 0 32 15 0 32 15 0 32 15 0 32 15 0 32 15 0 32 15 0 32 15 0 219 3 0 32 0 0 219 3 0 32 15 0 32 15 0 32 15 0 32 15 0 32 15 0 32 15 0 32 15 0 32 15 0 32 15 0 32 15 0 32 15 0 220 3 0 220 3 0 220 3 0 220 3 0 220 3 0 220 3 0 220 3 0 220 3 0 220 3 0 220 3 0 219 4 0 
219 15 0 32 15 0 219 3 0 32 0 0 219 3 0 219 0 0 219 0 0 219 0 0 223 0 0 223 0 0 223 0 0 223 0 0 223 0 0 223 0 0 223 0 0 32 3 0 32 0 0 32 3 0 32 15 0 32 15 0 32 15 0 32 15 0 32 15 0 32 15 0 32 15 0 219 3 0 32 0 0 219 3 0 32 15 0 32 15 0 32 15 0 32 15 0 32 15 0 32 15 0 32 15 0 32 15 0 32 15 0 32 15 0 32 15 0 219 3 0 32 0 0 32 0 0 32 0 0 32 0 0 32 0 0 32 0 0 32 0 0 32 0 0 32 0 0 32 0 0 
219 15 0 32 15 0 219 3 0 32 0 0 219 3 0 220 3 0 220 3 0 220 3 0 220 3 0 220 3 0 220 3 0 220 3 0 220 3 0 220 3 0 220 3 0 220 3 0 220 3 0 220 3 0 220 3 0 220 3 0 220 3 0 220 3 0 220 3 0 220 3 0 220 3 0 219 3 0 219 3 0 219 3 0 220 3 0 220 3 0 220 3 0 220 3 0 220 3 0 220 3 0 220 3 0 220 3 0 220 3 0 220 3 0 220 3 0 219 3 0 32 0 0 219 3 0 223 3 0 223 3 0 223 3 0 223 3 0 223 3 0 223 3 0 223 3 0 219 4 0 
219 15 0 32 15 0 219 3 0 32 0 0 32 0 0 32 0 0 32 0 0 32 0 0 32 0 0 32 0 0 32 0 0 32 0 0 32 0 0 32 0 0 32 0 0 32 0 0 32 0 0 32 3 0 32 0 0 32 15 0 32 15 0 32 15 0 32 15 0 32 15 0 32 15 0 32 0 0 32 0 0 32 0 0 32 0 0 32 0 0 32 0 0 32 0 0 32 0 0 32 0 0 32 0 0 32 0 0 32 0 0 32 0 0 32 0 0 219 13 0 32 0 0 219 3 0 32 15 0 69 0 0 69 0 0 69 7 0 78 7 0 68 7 0 32 15 0 219 15 0 
219 15 0 32 15 0 223 3 0 223 3 0 223 3 0 223 3 0 223 3 0 223 3 0 223 3 0 223 3 0 223 3 0 223 3 0 223 3 0 223 3 0 223 3 0 223 3 0 223 3 0 223 3 0 223 3 0 223 3 0 223 3 0 223 3 0 223 3 0 223 3 0 223 3 0 223 3 0 223 3 0 223 3 0 223 3 0 223 3 0 223 3 0 223 3 0 223 3 0 223 3 0 223 3 0 223 3 0 223 3 0 223 3 0 223 3 0 223 3 0 223 3 0 223 3 0 32 15 0 32 15 0 32 15 0 32 15 0 32 15 0 32 15 0 32 15 0 219 15 0 
219 15 0 32 15 0 220 0 0 32 15 0 32 15 0 32 15 0 32 15 0 32 15 0 220 0 0 220 0 0 220 0 0 220 0 0 220 0 0 220 0 0 220 0 0 220 0 0 32 15 0 32 15 0 32 15 0 32 15 0 32 15 0 32 15 0 32 15 0 32 15 0 32 15 0 32 15 0 32 15 0 32 15 0 32 15 0 32 15 0 32 15 0 32 15 0 32 15 0 32 15 0 32 15 0 32 15 0 32 15 0 32 15 0 32 15 0 32 15 0 32 15 0 32 15 0 32 15 0 32 15 0 32 15 0 32 15 0 32 15 0 32 15 0 32 15 0 219 15 0 
219 15 0 219 15 0 219 15 0 219 15 0 31 4 15 219 15 0 30 12 15 219 15 0 31 6 15 219 15 0 30 2 15 219 15 0 31 3 15 219 15 0 30 1 15 31 15 15 31 4 15 219 15 0 30 12 15 219 15 0 31 6 15 219 15 0 30 2 15 219 15 0 31 3 15 219 15 0 30 1 15 219 15 0 31 4 15 219 15 0 30 12 15 219 15 0 31 6 15 219 15 0 30 10 15 219 15 0 31 3 15 219 15 0 30 1 15 219 15 0 31 4 15 219 15 0 30 12 15 219 15 0 31 6 15 219 15 0 30 2 15 219 15 0 219 15 0 219 15 0
